*****E**************
*****-*****------***
*****-**----****---*
*-***----*********-*
*---****-*********-*
***----------*****-*
***-****-***-*****-*
*---****-***-***---*
**-----*-*******-***
**-***-*********-***
**-***-*****-***-***
**-***--***------***
**-****--**-****---*
**-*****-**-*****-**
**--****----*****-**
***------********-**
***-****-********-**
*---****-********-**
***---------------**
******|*************